11111111111111111111
1C0000P00C0010C00001
10C11111110C11C110C1
1000CCCCC11110001001
1CC11100000000CC00E1
11111111111111111111