1111111111111
100000P00C001
100C000000001
1C0E011101001
1111111111111

