1111111111111
100100P0000C1
100E011111001
1111111111111

