111111111111111
100000P00C00001
100C0C00000C001
1C0E01110100001
100011000000001
111111111111111