11111111111111111111
100000P00C0000000001
100C0C00000C00000001
1C0E0111010000000001
10001100000000000001
11111111111111111111