11111111111
10000110001
11100110011
10000000001