1111111111111
100000P000001
1000000000001
1C0E011101001
1111111111111

